20 71 1 1 11 47 1 2 18 43 1 3 18 53 1 4 20 31 1 5 20 70 1 6 42 48 1 7 31 39 1 8 28 56 1 9 36 19 1 10 34 71 1 11 56 42 2 1 107 40 2 2 60 58 2 3 32 71 2 4 21 67 2 5 60 34 2 6 21 31 2 7 18 42 2 8 60 48 2 9 60 43 2 10 29 56 2 11 30 39
18 70 1 1 10 47 1 2 21 39 1 3 20 51 1 4 16 36 1 5 20 67 1 6 39 50 1 7 26 45 1 8 22 54 1 9 39 24 1 10 29 66 1 11 56 43 2 1 107 40 2 2 60 58 2 3 22 71 2 4 18 69 2 5 60 30 2 6 24 20 2 7 19 36 2 8 60 44 2 9 60 43 2 10 21 49 2 11 23 36
63 26 1 1 26 38 1 2 52 36 1 3 50 40 1 4 53 19 1 5 49 61 1 6 68 36 1 7 62 31 1 8 64 45 1 9 81 24 1 10 82 66 1 11 87 51 2 1 107 40 2 2 85 50 2 3 60 63 2 4 53 60 2 5 84 25 2 6 67 24 2 7 56 34 2 8 85 44 2 9 86 33 2 10 60 51 2 11 60 36
99 10 1 1 29 33 1 2 56 28 1 3 55 40 1 4 58 16 1 5 58 50 1 6 87 33 1 7 76 19 1 8 77 39 1 9 96 9 1 10 87 50 1 11 94 22 2 1 111 34 2 2 98 43 2 3 80 43 2 4 64 45 2 5 87 13 2 6 84 13 2 7 58 17 2 8 98 36 2 9 97 16 2 10 78 32 2 11 87 26
111 7 1 1 26 36 1 2 60 30 1 3 56 43 1 4 60 15 1 5 62 54 1 6 96 37 1 7 86 26 1 8 83 44 1 9 102 20 1 10 104 41 1 11 104 28 2 1 111 34 2 2 104 42 2 3 93 49 2 4 59 45 2 5 100 18 2 6 94 15 2 7 63 15 2 8 104 29 2 9 101 27 2 10 90 39 2 11 90 28
15 64 1 1 11 48 1 2 19 43 1 3 21 51 1 4 20 35 1 5 17 61 1 6 39 48 1 7 29 42 1 8 23 51 1 9 51 20 1 10 36 65 1 11 62 40 2 1 107 40 2 2 63 59 2 3 29 63 2 4 16 64 2 5 67 29 2 6 52 24 2 7 19 36 2 8 64 50 2 9 63 40 2 10 24 50 2 11 52 33